11111111
1C0000P1
10100001
1E100001
11111111